grid:
32|8|8|8|8|8|8|8|8|8|8|8|8|8|8|8|32
16|1|2|2|2|2|2|2|2|2|2|2|2|2|2|3|16
16|9|25|10|10|10|10|10|10|10|10|10|10|10|10|11|16
16|9|10|10|10|10|10|10|10|10|10|10|10|10|10|11|16
16|9|10|10|10|10|53|53|58|10|10|10|10|10|10|11|16
16|9|10|10|10|10|52|52|54|10|10|63|10|10|10|11|16
16|9|10|10|10|10|10|10|10|63|10|10|10|63|10|11|16
16|9|10|10|10|10|10|10|10|10|10|63|10|10|10|11|16
16|9|10|10|10|10|10|26|10|10|10|10|10|10|10|11|16
16|9|10|10|63|10|10|10|10|10|10|10|10|10|10|11|16
16|9|10|10|10|10|10|10|10|10|10|63|10|10|10|11|16
16|9|10|10|10|10|10|10|10|10|10|10|10|10|10|11|16
16|9|10|10|10|10|10|10|10|10|10|10|10|10|10|11|16
16|17|18|18|18|18|18|18|18|18|18|18|18|18|18|19|16
32|8|8|8|8|8|8|8|8|8|8|8|8|8|8|8|32
one_ways:
59|12|6
62|10|7
60|14|7
61|12|8
61|5|10
61|12|11
